1111111111111111111111111
10000000000E000C00000C001
1P10010100100000101001001
1010010010101010001001001
100000000C00C000000000001
1111111111111111111111111